37 37 37 37 37 37 37 37 37 37 37 37 37 37 37 37 37 37 37 37 37 37 37 37 37 37 37 37 37 37 37 37 37 37 37 37 37 37 37 37 37 37 37 37 37 37 37 37 37 37
37 37 37 37 37 37 37 37 37 37 37 37 37 37 37 37 37 37 37 37 37 37 37 37 37 37 37 37 37 37 37 37 37 37 37 37 37 37 37 37 37 37 37 37 37 37 37 37 37 37
37 37 37 37 37 37 37 37 37 37 37 37 37 37 37 37 37 37 37 37 37 37 37 37 37 37 37 37 37 37 37 37 37 37 37 37 37 37 37 37 37 37 37 37 37 37 37 37 37 37
37 37 37 37 37 37 37 37 37 37 37 37 37 37 37 37 37 37 37 37 37 37 37 37 37 37 37 37 37 37 37 37 37 37 37 37 37 37 37 37 37 37 37 37 37 37 37 37 37 37
37 37 37 37 37 37 37 37 37 37 37 37 37 37 37 37 37 37 37 37 37 37 37 37 37 37 37 37 37 37 37 37 37 37 37 37 37 37 37 37 37 37 37 37 37 37 37 37 37 37
37 37 37 37 37 37 37 37 37 37 37 37 37 37 37 37 37 37 37 37 37 37 37 37 37 37 37 37 37 37 37 37 37 37 37 37 37 37 37 37 37 37 37 37 37 37 37 37 37 37
37 37 37 37 37 37 37 37 37 37 37 37 37 37 37 37 37 37 37 37 37 37 37 37 37 37 37 37 37 37 37 37 37 37 37 37 37 37 37 37 37 37 37 37 37 37 37 37 37 37
37 37 37 37 37 37 37 37 37 37 37 37 37 37 37 37 37 37 37 37 37 37 37 37 37 37 37 37 37 37 37 37 37 37 37 37 37 37 37 37 37 37 37 37 37 37 37 37 37 37
37 37 37 37 37 37 37 37 37 37 37 37 37 37 37 37 37 37 37 37 37 37 37 37 37 37 37 37 37 37 37 37 37 37 37 37 37 37 37 37 37 37 37 37 37 37 37 37 37 37
37 37 37 37 37 37 37 37 47 45 45 45 45 45 45 45 45 45 45 45 45 45 45 45 45 45 45 45 45 45 45 45 45 45 45 45 45 45 45 45 45 48 37 37 37 37 37 37 37 37
37 37 37 37 37 37 37 37 43 35 35 35 35 35 35 35 35 35 35 35 35 35 35 35 35 35 35 35 35 35 35 35 35 35 35 35 35 35 35 35 35 42 37 37 37 37 37 37 37 37
37 37 37 37 37 37 37 37 43 35 35 51 52 35 35 35 35 35 35 35 35 35 35 35 35 35 35 35 35 35 35 35 35 35 35 35 35 35 35 35 35 42 37 37 37 37 37 37 37 37
37 37 37 37 37 37 37 37 43 35 35 53 54 35 35 35 35 35 35 35 35 35 35 35 35 35 35 35 35 35 35 35 35 35 35 35 35 35 35 35 35 42 37 37 37 37 37 37 37 37
37 37 37 37 37 37 37 37 43 35 35 35 35 31 29 29 29 29 29 29 29 29 29 32 35 35 35 35 35 35 35 35 35 35 35 35 35 35 35 35 35 42 37 37 37 37 37 37 37 37
37 37 37 37 37 37 37 37 43 35 35 35 35 27 22 22 22 22 22 22 22 22 22 26 35 35 35 35 35 35 35 35 35 35 35 35 35 35 35 35 35 42 37 37 37 37 37 37 37 37
37 37 37 37 37 37 37 37 43 35 35 35 35 33 24 24 24 24 24 24 24 25 22 26 35 35 35 31 29 29 29 29 32 35 35 35 35 35 35 35 35 42 37 37 37 37 37 37 37 37
37 37 37 37 37 37 37 37 43 35 35 35 35 51 52 35 35 35 35 35 35 27 22 26 35 35 35 27 22 22 22 22 26 35 35 35 35 35 35 35 35 42 37 37 37 37 37 37 37 37
37 37 37 37 37 37 37 37 43 35 35 35 35 53 54 10 35 35 10 10 35 27 22 28 29 29 29 30 22 23 24 24 34 35 35 35 35 35 35 35 35 42 37 37 37 37 37 37 37 37
37 37 37 37 37 37 37 37 43 35 35 35 35 35 35 11 35 10 11 11 35 27 22 22 22 22 22 22 22 26 35 35 35 35 35 35 35 35 35 35 35 42 37 37 37 37 37 37 37 37
37 37 37 37 37 37 37 37 43 35 35 35 35 35 35 35 10 11 35 35 35 27 22 23 24 24 24 24 24 34 35 35 35 35 35 35 35 35 35 35 35 42 37 37 37 37 37 37 37 37
37 37 37 37 37 37 37 37 43 35 35 35 35 35 35 35 11 10 35 35 35 27 22 26 51 52 35 35 35 35 35 35 35 35 35 35 35 35 35 35 35 42 37 37 37 37 37 37 37 37
37 37 37 37 37 37 37 37 43 35 35 35 35 35 35 35 35 11 10 35 35 27 22 26 53 54 35 35 35 35 35 35 35 35 35 35 35 35 35 35 35 42 37 37 37 37 37 37 37 37
37 37 37 37 37 37 37 37 43 35 35 35 35 35 35 35 35 35 11 35 35 27 22 26 35 35 35 35 35 35 35 35 35 35 35 35 35 35 35 35 35 42 37 37 37 37 37 37 37 37
37 37 37 37 37 37 37 37 43 35 35 35 35 35 35 35 35 35 35 35 35 27 22 26 35 35 35 35 35 35 35 35 35 35 35 35 35 35 35 35 35 42 37 37 37 37 37 37 37 37
37 37 37 37 37 37 37 37 43 35 35 35 35 35 35 35 35 35 35 35 35 27 22 26 35 35 35 35 35 35 35 35 35 35 35 35 35 35 35 35 35 42 37 37 37 37 37 37 37 37
37 37 37 37 37 37 37 37 43 35 35 35 35 35 35 35 35 35 35 35 35 27 22 26 35 35 35 35 35 35 35 35 35 35 35 35 35 35 35 35 35 42 37 37 37 37 37 37 37 37
37 37 37 37 37 37 37 37 43 35 35 35 35 35 35 35 35 35 35 35 35 27 22 26 35 35 35 35 35 35 35 35 35 35 35 35 35 35 35 35 35 42 37 37 37 37 37 37 37 37
37 37 37 37 37 37 37 37 43 35 35 35 35 35 35 35 31 29 29 29 29 30 22 28 29 29 29 29 32 35 35 35 35 35 35 35 35 35 35 35 35 42 37 37 37 37 37 37 37 37
37 37 37 37 37 37 37 37 43 35 35 35 35 35 35 35 27 22 22 22 22 22 22 22 22 22 22 22 26 35 35 35 35 35 35 35 35 35 35 35 35 42 37 37 37 37 37 37 37 37
37 37 37 37 37 37 37 37 43 35 35 35 35 35 35 35 33 24 25 22 23 24 24 24 24 24 25 22 26 35 35 35 35 35 35 35 35 35 35 35 35 42 37 37 37 37 37 37 37 37
37 37 37 37 37 37 37 37 43 35 35 35 35 35 35 35 35 35 27 22 26 35 35 35 35 35 27 22 26 35 35 35 35 35 35 35 35 35 35 35 35 42 37 37 37 37 37 37 37 37
37 37 37 37 37 37 37 37 43 35 35 35 35 35 35 51 52 35 27 22 26 35 35 35 35 35 27 22 26 35 35 35 35 35 35 35 35 35 35 35 35 42 37 37 37 37 37 37 37 37
37 37 37 37 37 37 37 37 43 35 35 35 35 35 35 53 54 35 27 22 26 35 35 35 35 35 27 22 28 29 29 29 32 35 35 35 35 35 35 35 35 42 37 37 37 37 37 37 37 37
37 37 37 37 37 37 37 37 43 35 35 35 35 35 35 35 35 35 33 24 34 35 35 35 35 35 27 22 22 22 22 22 26 35 35 35 35 35 35 35 35 42 37 37 37 37 37 37 37 37
37 37 37 37 37 37 37 37 43 35 35 35 35 35 35 35 35 51 52 35 35 35 35 35 35 35 33 24 24 24 24 24 34 35 35 35 35 35 35 35 35 42 37 37 37 37 37 37 37 37
37 37 37 37 37 37 37 37 43 35 35 35 35 35 35 35 35 53 54 35 35 35 35 35 35 35 35 35 35 35 35 35 35 35 35 35 35 35 35 35 35 42 37 37 37 37 37 37 37 37
37 37 37 37 37 37 37 37 43 35 35 35 35 35 35 35 35 35 35 35 35 35 35 35 35 35 35 35 35 35 35 35 35 35 35 35 35 35 35 35 35 42 37 37 37 37 37 37 37 37
37 37 37 37 37 37 37 37 43 35 35 35 35 35 35 35 35 35 35 35 35 35 35 35 35 35 35 35 35 35 35 35 35 35 35 35 35 35 35 35 35 42 37 37 37 37 37 37 37 37
37 37 37 37 37 37 37 37 43 35 35 35 35 35 35 35 35 35 35 35 35 35 35 35 35 35 35 35 35 35 35 35 35 35 35 35 35 35 35 35 35 42 37 37 37 37 37 37 37 37
37 37 37 37 37 37 37 37 43 35 35 35 35 35 35 35 35 35 35 35 35 35 35 35 35 35 35 35 35 35 35 35 35 35 35 35 35 35 35 35 35 42 37 37 37 37 37 37 37 37
37 37 37 37 37 37 37 37 49 40 40 40 40 40 40 40 40 40 40 40 40 40 40 40 40 40 40 40 40 40 40 40 40 40 40 40 40 40 40 40 40 50 37 37 37 37 37 37 37 37
37 37 37 37 37 37 37 37 37 37 37 37 37 37 37 37 37 37 37 37 37 37 37 37 37 37 37 37 37 37 37 37 37 37 37 37 37 37 37 37 37 37 37 37 37 37 37 37 37 37
37 37 37 37 37 37 37 37 37 37 37 37 37 37 37 37 37 37 37 37 37 37 37 37 37 37 37 37 37 37 37 37 37 37 37 37 37 37 37 37 37 37 37 37 37 37 37 37 37 37
37 37 37 37 37 37 37 37 37 37 37 37 37 37 37 37 37 37 37 37 37 37 37 37 37 37 37 37 37 37 37 37 37 37 37 37 37 37 37 37 37 37 37 37 37 37 37 37 37 37
37 37 37 37 37 37 37 37 37 37 37 37 37 37 37 37 37 37 37 37 37 37 37 37 37 37 37 37 37 37 37 37 37 37 37 37 37 37 37 37 37 37 37 37 37 37 37 37 37 37
37 37 37 37 37 37 37 37 37 37 37 37 37 37 37 37 37 37 37 37 37 37 37 37 37 37 37 37 37 37 37 37 37 37 37 37 37 37 37 37 37 37 37 37 37 37 37 37 37 37
37 37 37 37 37 37 37 37 37 37 37 37 37 37 37 37 37 37 37 37 37 37 37 37 37 37 37 37 37 37 37 37 37 37 37 37 37 37 37 37 37 37 37 37 37 37 37 37 37 37
37 37 37 37 37 37 37 37 37 37 37 37 37 37 37 37 37 37 37 37 37 37 37 37 37 37 37 37 37 37 37 37 37 37 37 37 37 37 37 37 37 37 37 37 37 37 37 37 37 37
37 37 37 37 37 37 37 37 37 37 37 37 37 37 37 37 37 37 37 37 37 37 37 37 37 37 37 37 37 37 37 37 37 37 37 37 37 37 37 37 37 37 37 37 37 37 37 37 37 37
37 37 37 37 37 37 37 37 37 37 37 37 37 37 37 37 37 37 37 37 37 37 37 37 37 37 37 37 37 37 37 37 37 37 37 37 37 37 37 37 37 37 37 37 37 37 37 37 37 37