12 12 12 12 12 12 12 12 12 12 12 12 12 12 12 12 12 12 12 12 12 12 12 12 12 12 12 12 12 12 12 12 12 12 12 12 12 12 12 12 12 12 12 12 12 12 12 12 12 12 
12 12 12 12 12 12 12 12 12 12 12 12 12 12 13 12 12 12 12 12 12 12 12 12 12 12 12 12 12 12 12 12 12 12 12 12 12 12 12 12 12 12 12 12 12 12 12 12 12 12 
12 12 12 12 12 12 12 13 12 12 12 12 12 12 12 12 12 12 12 12 12 12 12 12 12 13 12 12 12 12 12 12 12 13 12 12 12 12 12 12 12 12 12 12 12 12 12 12 12 12 
12 12 12 12 13 12 12 12 12 12 12 13 12 12 12 12 12 12 13 12 12 12 12 12 12 12 12 13 12 12 12 12 12 12 12 12 12 12 12 12 12 13 12 12 12 12 12 12 12 12  
12 12 12 12 12 12 12 12 12 13 12 12 12 12 12 13 12 12 12 12 12 12 12 13 12 12 12 12 12 12 12 13 12 12 13 12 12 12 13 12 12 12 12 12 12 12 12 12 12 12 
12 12 12 12 12 12 12 12 12 12 12 12 12 12 12 12 12 12 12 12 12 13 12 12 12 12 12 12 12 13 12 12 12 12 12 12 13 12 12 12 12 12 12 13 12 12 12 12 12 12  
12 12 12 12 12 12 12 13 22 20 20 20 20 20 20 20 23 12 22 20 20 20 20 20 20 20 20 23 12 12 12 22 20 20 20 20 20 20 20 20 20 20 23 12 12 12 12 12 12 12 
12 12 12 12 12 12 12 12 18 52 47 47 47 47 47 52 19 20 21 52 47 47 11 47 53 47 47 19 20 20 20 21 52 53 35 33 33 33 33 33 33 36 17 12 12 13 12 12 12 12
12 12 13 12 12 12 12 12 18 11 47 47 47 53 47 11 11 11 11 11 47 14 15 15 15 16 53 11 11 11 11 11 11 11 31 26 26 26 26 26 26 30 17 12 12 12 12 12 12 12
12 12 12 12 12 12 12 12 18 10 47 47 47 47 47 10 10 10 10 10 53 17 12 12 12 18 47 10 10 10 10 10 10 10 31 26 26 26 26 26 26 30 17 12 12 12 12 12 12 12
12 12 12 13 12 12 12 12 18 11 47 53 47 47 47 47 54 47 47 54 47 17 12 12 12 18 11 11 11 11 11 11 11 11 31 26 26 26 26 26 26 30 17 12 13 12 12 12 12 12
12 12 12 12 13 12 12 12 18 10 47 47 47 53 47 47 47 47 47 47 47 19 20 20 20 21 47 10 10 10 10 10 10 10 31 26 26 26 26 26 26 30 17 12 12 12 12 12 12 12
12 12 12 12 12 12 12 12 18 11 47 53 47 47 47 11 47 47 11 11 11 47 35 33 36 47 47 53 47 53 47 53 47 47 37 28 28 29 26 27 28 38 17 13 12 12 12 12 12 12
12 12 12 12 12 12 12 12 18 10 52 52 47 52 52 10 47 47 10 10 10 10 31 26 30 11 52 52 52 53 11 11 11 52 52 11 11 31 26 30 14 15 25 12 12 12 12 12 12 12
12 12 12 12 13 12 12 12 24 16 11 11 47 11 11 52 11 11 11 11 11 11 11 26 30 10 11 11 11 11 10 10 10 11 11 10 10 31 26 30 17 12 12 12 12 13 12 12 12 12
12 12 12 12 12 12 12 12 12 18 10 10 47 10 10 52 10 10 10 10 10 10 10 31 26 30 10 10 10 10 11 11 41 17 10 10 11 11 11 31 26 30 17 12 12 12 12 12 12 12
12 12 12 12 12 12 12 12 22 21 11 11 47 11 11 52 11 11 52 11 11 11 53 31 26 30 47 47 47 11 10 10 10 11 11 10 10 10 31 26 30 17 12 12 12 12 12 13 12 12
12 12 13 12 12 12 12 22 21 11 10 10 53 10 10 54 10 10 54 10 10 10 31 26 30 11 52 52 52 10 11 11 11 10 10 35 33 34 26 30 17 12 12 13 12 12 12 12 12 12
12 12 12 12 12 12 12 18 52 10 47 47 47 11 11 11 11 11 11 11 11 11 31 26 30 10 11 11 11 11 10 10 10 11 11 31 26 26 26 30 17 12 12 12 12 12 12 12 12 12
12 12 12 13 12 12 12 18 11 11 47 11 11 10 10 10 10 10 10 10 10 47 31 26 30 47 10 10 10 10 11 11 11 10 10 31 26 27 28 38 17 12 13 12 12 12 12 12 12 12
12 12 12 12 12 12 12 18 10 10 47 10 10 47 35 33 33 33 33 33 33 33 34 26 32 33 33 33 33 36 10 10 10 35 33 34 26 30 47 52 17 12 12 12 12 12 12 12 12 12
12 12 12 12 12 13 12 18 11 11 47 11 11 47 31 26 26 26 26 26 26 26 26 26 26 26 26 26 26 30 47 53 47 31 26 26 26 30 47 14 25 12 12 12 12 12 12 12 12 12
12 12 12 12 12 12 13 18 10 10 47 10 10 47 37 28 28 28 28 28 28 28 29 26 27 28 28 28 28 38 11 11 11 37 28 29 26 30 47 17 12 13 12 12 12 12 12 12 12 12
12 12 12 12 12 12 12 24 16 11 53 11 11 53 11 11 11 11 11 11 11 47 31 26 30 47 52 52 52 52 10 10 10 11 52 31 26 30 47 17 12 12 12 12 13 12 12 12 12 12
12 12 12 12 12 12 12 12 18 10 47 10 10 47 10 10 10 10 10 10 10 10 31 26 30 11 11 52 52 11 11 11 11 10 11 31 26 30 11 17 12 12 12 12 12 12 12 12 12 12
12 12 12 12 12 13 12 22 21 11 47 11 11 53 47 11 11 11 11 11 11 11 31 26 30 10 10 11 11 10 10 10 10 11 10 31 26 30 53 17 12 12 12 13 12 12 12 12 12 12
12 12 12 12 12 12 12 18 52 10 47 10 10 52 47 10 10 10 10 10 10 10 31 26 30 11 11 10 10 11 11 11 11 10 11 31 26 30 47 17 12 12 12 12 12 12 12 12 12 12
12 12 12 13 12 12 12 18 11 11 47 11 11 11 47 11 11 11 11 11 11 11 31 26 30 10 10 47 11 10 10 10 10 11 10 31 26 30 53 17 12 13 12 12 12 12 12 12 12 12
12 12 12 12 12 12 12 18 10 10 53 10 10 10 47 10 10 10 10 10 10 10 31 26 30 11 11 52 10 11 47 11 11 10 11 31 26 30 47 17 12 12 12 12 12 12 12 12 12 12
12 12 12 12 12 12 13 18 11 11 47 47 47 47 47 47 11 11 11 11 11 11 31 26 30 10 10 11 11 10 53 10 10 11 10 37 28 38 47 17 12 12 12 12 13 12 12 12 12 12
12 12 12 12 12 12 12 18 10 10 47 53 47 53 47 47 10 10 10 10 10 10 31 26 30 11 11 10 10 11 10 11 11 10 11 52 53 52 14 25 12 12 13 12 12 12 12 12 12 12
12 12 12 12 12 12 12 24 16 11 53 47 47 47 47 53 11 11 11 11 11 11 31 26 30 10 10 11 11 10 11 10 10 11 10 53 47 47 17 12 12 12 12 12 12 12 12 12 12 12
12 12 12 12 12 13 12 12 18 10 47 47 53 47 47 47 10 10 10 10 10 10 31 26 30 11 11 10 10 11 10 11 11 10 11 47 47 53 17 12 12 12 12 12 12 12 13 12 12 12
12 12 12 12 12 12 12 12 18 11 53 47 47 47 53 47 11 11 11 11 11 11 31 26 30 10 10 11 11 10 11 10 10 11 10 53 53 11 17 12 12 13 12 12 12 12 12 12 12 12
12 12 12 12 12 12 12 12 18 10 47 53 47 47 47 47 10 10 10 10 10 10 31 26 30 11 11 10 10 11 10 11 11 10 11 47 47 47 17 12 12 12 12 12 12 12 12 12 12 12
12 12 12 12 13 12 12 22 21 11 11 11 11 11 11 11 11 11 11 11 52 52 37 28 38 10 10 11 11 10 11 10 10 11 10 11 47 47 19 23 12 12 12 12 12 12 12 12 12 12
12 12 12 12 12 12 12 18 52 10 10 10 10 10 10 10 10 10 10 10 47 47 47 47 47 47 47 10 10 11 10 11 11 10 47 47 53 47 47 19 23 12 12 12 13 12 12 12 12 12
12 12 12 12 12 12 13 18 11 11 11 11 11 11 11 11 11 11 11 47 47 47 47 47 53 47 47 52 11 10 47 10 10 53 47 47 47 47 47 47 17 12 12 12 12 12 12 12 12 12
12 12 12 12 12 12 12 18 10 10 10 10 10 10 10 10 10 10 10 52 47 47 53 47 47 53 47 52 10 11 11 11 47 47 47 53 47 11 47 47 17 12 13 12 12 12 12 12 12 12
12 12 12 12 12 12 12 18 11 11 42 11 11 47 53 47 47 47 47 47 52 47 47 47 47 47 47 47 47 10 10 10 47 53 47 47 47 52 47 47 17 12 12 12 12 12 12 12 12 12
12 12 13 12 12 12 12 18 10 10 53 10 10 47 47 47 47 53 47 47 47 47 53 47 47 47 52 47 47 47 47 53 47 47 52 47 47 47 47 53 17 12 12 12 12 13 12 12 12 12
12 12 12 12 12 12 12 18 11 11 47 53 47 53 52 14 15 15 16 35 53 47 47 47 52 47 47 14 15 15 16 47 53 47 53 47 47 47 11 47 17 12 12 12 12 12 12 13 12 12
12 12 12 12 12 12 12 18 10 10 52 52 52 52 14 25 12 12 24 16 47 47 53 47 47 47 14 25 12 12 18 47 47 52 47 47 52 53 47 53 17 12 12 12 12 12 12 12 12 12
12 12 12 12 13 12 12 24 15 15 15 15 15 15 25 12 12 12 12 24 15 15 15 15 15 15 25 12 13 12 24 16 47 11 47 47 47 47 14 15 25 12 13 12 12 12 12 12 12 12
12 12 12 12 12 12 12 12 12 12 12 12 12 12 12 12 12 12 13 12 12 12 12 12 12 12 12 12 12 12 12 24 15 15 15 15 15 15 25 12 12 12 12 12 12 12 13 12 12 12 
12 12 12 12 12 12 12 12 12 12 12 13 12 12 12 12 13 12 12 12 12 12 12 12 12 12 12 12 12 12 12 12 12 12 12 12 13 12 12 12 12 12 12 13 12 12 12 12 12 12 
12 12 12 12 12 12 13 12 12 12 12 12 12 12 12 12 12 12 12 12 12 12 12 12 13 12 12 12 12 13 12 12 12 12 12 12 12 12 12 12 12 12 12 12 12 12 12 12 12 12 
12 12 12 12 12 12 12 12 12 12 12 12 12 12 13 12 12 12 12 12 13 12 12 12 12 12 12 12 12 12 12 12 13 12 12 12 12 12 12 13 12 12 12 12 12 12 12 12 12 12 
12 12 12 12 12 12 12 12 12 12 12 12 12 12 12 12 12 12 12 12 12 12 12 12 12 12 12 13 12 12 12 12 12 12 12 12 12 12 12 12 12 12 12 12 12 13 12 12 12 12 
12 12 12 12 12 12 12 12 12 12 12 12 12 12 12 12 12 12 12 12 12 12 12 12 12 12 12 12 12 12 12 12 12 12 12 12 12 12 12 12 12 12 12 12 12 12 12 12 12 12 